11111111111111111111111111
100C0000000010000000000001
100000000000100E0000000001
100000P0000010000000000B01
1000000000000000000C000001
1000000B000010000C00000001
10000000000010000000000001
11111111111111111111111111