11111111111
1P0BC0000C1
10100000001
10000000001
10000000001
1C1000000E1
11111111111